111111111111111111
111111111111111111
113000000000000011
110000000000000011
110000000000000011
110000000000000011
110000000000000011
110000002000000011
110000000000000011
110000000000000011
110000000000000011
110000000000000011
110000000000000011
110000000000000011
110000000000000011
110000000000000011
111111111111111111
111111111111111111