111111111111111111111111111111111111
111111111111111111111111111111111111
113000000000000011110000000000000011
110200000000000011110000000000000011
110000000000000011110000000000000011
110000000000000011110000000000000011
110000000000000011110000000000000011
110000000000000011110000000000000011
110000000000000011110000000000000011
110000000000000011110000000000000011
110000000000000011110000000000000011
110000000000000011110000000000000011
110000000000000011110000000000000011
110000000000000011110000000000000011
110000000000000011110000000000000011
110000000000000011110000000000000011
111111111111111111111111111111111111
111111111111111111111111111111111111
111111111111111111111111111111111111
111111111111111111111111111111111111
110000000000000011110000000000000011
110200000000000011110000000000000011
110000000000000011110000000000000011
110000000000000011110000000000000011
110000000000000011110000000000000011
110000000000000011110000000000000011
110000000000000011110000000000000011
110000000000000011110000000000000011
110000000000000011110000000000000011
110000000000000011110000000000000011
110000000000000011110000000000000011
110000000000000011110000000000000011
110000000000000011110000000000000011
110000000000000011110000000000000011
111111111111111111111111111111111111
111111111111111111111111111111111111