1111111111111
1030000000001
1200001000001
1000001000001
1000000000001
1111111111111
