11111111111111111111111111111111111111111111111111111111111111111111111111111111111111111111111111111111111111
10020000000000000000000200000000000000000000200000000000000000000200000000000000000000200000000000000000002001
10020000000000000000000200000000000000000000200000000000000000000200000000000000000000200000000000000000002001
10020000000000000000000200000000000000000000200000000000000000000200000000000000000000200000000000000000002001
10420000000000003000400200000000000000000400200000000000000000040200000000000000000000200000000000000004002401
10020000000000000000000200000000000000000000200000000000000000000200000000000000000000200000000000000000002001
10020000000000000000000200000000000000000000200000000000000000000200000000000000000000200000000000000000002001
11111111111111111111111111111111111111111111111111111111111111111111111111111111111111111111111111111111111111