111111111111111111
111111111111111111
113222221122222211
112222221122222211
112211222222112211
112211222222112211
112222221122222211
112222221122222211
111122111111221111
111122111111221111
112222221122222211
112222221122222211
112211222222112211
112211222222112211
112222221122222211
112222221122222211
111111111111111111
111111111111111111