111111111111111111
111111111111111111
113222222222222211
112222222222222211
112222222222222211
112222222222222211
112222222222222211
112222222222222211
112222222222222211
112222222222222211
112222222222222211
112222222222222211
112222222222222211
112222222222222211
112222222222222211
112222222222222211
111111111111111111
111111111111111111