111111111111
100000000001
100000000001
100000000001
100030000001
100000000001
100004000001
100000000001
100000050001
102000000001
100000000001
111111111111