111111111111111111
111111111111111111
113000001100000011
110000001100000011
112011000000110011
110011000000110011
110000001100000011
110000001100000011
111100111111001111
111100111111001111
110000001100000011
110000001100000011
110011000000110011
110011000000110011
110000001100000011
110000001100000011
111111111111111111
111111111111111111