111111
103001
120001
100001
100001
111111
