111111
130021
100001
100001
100001
111111